########################
#\\... ......#     #   #
###.#. ...*..#         #
  #*#. ... ..      #   #
 ## #.   \ ..#     #   #
## .#..*.. **#######   #
#.  #..... ..\\\*. #   #
#...#.###. ####\\\ #\  #
#...#. #   ...## \ #\  #
#...#..#.. .\..# \ #\  #
#......#.* ....#   #####
####...#.. ..###*####
#...*..#.. .........#
#...*..#.. ....***..#
#....... # ####.....#
#........*R..\\\   .#
##########L##########