##################################################################################
#********************************************************************************#
#********************************************************************************#
#                                                                                #
#                                                                                #
#                                                                                #
#                                                                                #
#                                                                                #
#                                                                                #
#                                                                                #
#                                                                                #
#                                                                                #
#                                                                                #
#                                                                                #
#                                                                                #
#                                                                                #
#                                                                                #
#                                        \\\\\\\                                 #
#                                                                              ###
#                                                                                #
#                                                                                #
#R                                       \ \ \ \                                L#
##################################################################################