##################################################################################
#                                                                                #
#               *                                                                #
#                                *                                               #
#          \                                                                \    #
#                       \     *       \ \       \\\          ....\...............#
#.....*********...........................................****...........\..    .#
#.....................................................................\......\...#
#.................*.........*......................................\.............#
#................................................................................#
#........................................................\.......................#
#................................................................................#
#.......\........................................................................#
#.......\........................................................................#
#.......\..................\.....................................................#
#..........................\.............\\\\\\\...........\\\...................#
#..........................\...................................................###
#..................................................................\\............#
#................................................................................#
#R.......................................\.\.\.\................................L#
##################################################################################