################################ ##
#******#******#******#**********L #
##*****##*****##*****##*********  #
#*#****#*#****#*#****#*#*******## #
# *#***# *#***# *#***# *#*****# # #
#  *#**#  *#**#  *#**#  *#***#  # #
#   *#*#   *#*#   *#*#   *#*#   # #
#    *A*    *B*    *C*    *D*   # #
#     \      \      \      \    # #
#     *      *      *      *    # #
#*******************************# #
#R..............................# #
#\                              # #
#1                              # #
#                               # #
################################# #
#      WE                         #
###################################

Growth 1
Trampoline A targets 1
Trampoline B targets 1
Trampoline C targets 1
Trampoline D targets 1
Trampoline E targets 1
