################### 
#*************   ## 
##***********# * ## 
###*********##.*.## 
####*******####*### 
#####*****#####*### 
######***######*### 
#####  *#######*### 
#\     .      #*### 
#\     \      #*### 
#\     **     #*### 
#\     ##     #*### 
#\     \ \    #*### 
#\    ** **   #*### 
#\    ## ##   #*### 
#\            # ### 
#             #*### 
#    ** ** ** #*\## 
#### ## ## ## #*### 
####           * ## 
#### ## ## ## ## ## 
##   ## #   #  # R# 
##   L# #\  #  #  # 
## * ## # \ # ##  # 
## #### #  \# \# *# 
################### 
