###############
#.............#
#.............#
#.............#
#.............#
#.............#
#.............#
#.............#
#.............#
#.............#
#...*.........#
#...*.........#
LR..*.\.......#
###############
